3d3d3d3d3d3d3d3d3d3d3d3d
3d000000000000000000003d
3d000000000000000000003d
3d000000000000000000003d
3d0000000000000000000000
3d000000000000000000003d
3d010002000300040000003d
3d3d3d3d3d3d3d3d3d003d3d

tilesheet outdoors
hero 3 1
song seven_circles
neighbore test_east
neighbors test_south
door 7 6 test_inside 6 7
sprite 5 4 bug
