3d3d3d3d3d3d3d3d3d3d3d3d
3d000000000000000000003d
3d000000000000000000003d
3d000000000000000000003d
3d000000000000000000003d
3d000000000000000000003d
3d010002000300040000003d
3d3d3d3d3d3d3d3d3d3d3d3d

tilesheet outdoors
hero 3 1
song seven_circles
