f1f2f0f1f2f0f1f2f3f0f1f2
e2e0e1e2e3c5c6c7e0e1e2e0
f2f0f1f2f3d5d6d7f0f1f2f0
e1e2e0e1e2e5e6e7e3e0e1e2
f1f2f0f1f2f5f6f7f3f0f1f2
7b000100000000000000007b
7b000000030000000000017b
7b7b7b7b7b7b7b7b7b7b7b7b

tilesheet outdoors
door 6 4 test_south 1 1
