000000000000530000000000
000000000100530002000000
000200000200530000000000
000200000000530001000200
000000000000530000000200
000000000000530000000000
000000000000530000000000
000000000000530000e0e1e2

tilesheet outdoors
neighbors map1666658804425
neighborw map1666658719968
neighborn map1666658807569
neighbore map1666658951370
