2c0000003519261837005300
2c0000000035192700005300
2c0200020201252700005300
2c0001000000252700016071
2c0000010000252816170000
2c0000000002353636370000
2c0000000000000002000000
2c0000000000000000000000

tilesheet outdoors
neighborn map1666658328558
neighbors map1666658372757
neighbore map1666658708224
