3b3b3b3b3b3b3b3b3b3b3b3b
000000000000000000000000
000000007475460000000000
000000000000570000000000
000000000074560000000000
000000000000570000000000
000000007475660000000000
000000000000000000000000

tilesheet outdoors
neighborw map1666658618544
neighbore map1666658655071
neighbors map1666658809105
