2c0000000000000000000000
2c0000000000000000000000
2c0000004700470000000000
2c0000006475560000000000
2c0000000000670000000000
2c0000000000000000000000
2c0000000000000000000000
2c0000000000000000000000

tilesheet outdoors
neighborn map1666658372757
neighbors map1666658402774
neighbore map1666658719968
