000000000000000053000000
000201020000020153000000
000000000000000053000000
000000000000000053020000
000000000000000060717171
010000000000000000000000
000000000000010000000000
000000000000000002020001

tilesheet outdoors
neighborn map1666658708224
neighborw map1666658372757
neighbors map1666658719968
neighbore map1666658807569
