3b3b3b3b3b3b3b3b3b3b3b3b
000000000000000000000000
000000007475460000000000
000000000000570000000000
000000000000570000000000
000000000000670000000000
000000000000000000000000
000000000000000000000000

tilesheet outdoors
neighborw map1666658667512
neighbore map1666658675841
neighbors map1666658925938
