f0f1f2000000000000000000
e2e0e2000000000000000000
f2f0f2000000000043000001
e0e1e2000000020053000000
f0f1f2000000000053000000
000000000002000053000000
717171717171717162000100
000000000100000000000000

tilesheet outdoors
neighbore map1666658973442
neighborn map1666658953235
neighborw map1666658977371
neighbors map1666658981851
