000000000000000202000000
000002000000000000000000
000000000000000001000000
010000000002000100000000
000000000000000001000000
020000000000000000000000
000000000000000200020002
000000000000000000000000

tilesheet outdoors
neighborn map1666658735497
neighborw map1666658419590
neighbors map1666658745097
neighbore map1666658798617
