3b3b3b3b3b3b3b3b3b3b3b3b
000000000000000000000000
000000004475460000000000
000000005700570000000000
000000005475560000000000
000000005700570000000000
000000006475660000000000
000000000000000000000000

tilesheet outdoors
neighborw map1666658672296
neighbore map1666658680944
neighbors map1666658927435
