000000000000000000000000
000000000000000000000000
0000000000003d3d3d000000
00000000000000001a1c0000
00000000000000003a3c0000
000000003d3d3d3d00000000
000000000000000000000000
000000000000000000000000

tilesheet outdoors
neighborw map1666658924194
neighborn map1666658672296
neighbore map1666658927435
neighbors map1666658944114
