2b1d3b3b3b3b3b3b3b3b3b1e
1d3c0000000000000000002a
2c00003d003d001a1b1c002a
2c0000000000003a1e2c002a
2c00001a1b1c00013a3c002a
2c00003a3b3c00000000002a
2d1c0000000000010001002a
2b2d1b1b1b1c00001a1b1b2e

tilesheet outdoors
neighbors test_east
