3b3b3b3b3b3b3b3b3b3b3b3b
000000000000000000000000
000000000074754600000000
007700770000005700000000
000077000044756600000000
007700770057000000000000
000000000064757600000000
000000020000000000000000

tilesheet outdoors
neighborw map1666658328558
neighborn test_se
neighbore map1666658649344
neighbors map1666658708224
