00000000000000000000002a
00000000000000000000002a
00008485868788000000002a
00009495969798000000002a
0000a4a5a60000000000002a
00000000000000000000002a
00000000000000000000002a
1b1b1b1b1b1b1b1b1b1b1b2e

tilesheet outdoors
neighborn map1666659016706
neighborw map1666659023843
