2c0000000000000000000000
2c0000000000000000000000
2c0000004475760000000000
2c0000005700000000000000
2c0000005475460000000000
2c0000005700570000000000
2c0000006475660000000000
2c0000000000000000000000

tilesheet outdoors
neighborn map1666658402774
neighbors map1666658415501
neighbore map1666658730336
