000000000000020000010000
000001000000000000010000
000001000001000000000000
000000000000000000000000
717171717171420000000000
000000000000530000000200
000000020000530000000000
000000000000530000000000

tilesheet outdoors
neighbors map1666658806001
neighborw map1666658714873
neighborn map1666658809105
neighbore map1666658949219
