3b3b3b3b3b3b3b3b3b3b3b3b
000000000000000000000000
000000004700470000000000
000000005700570000000000
000000006475560000000000
000000000000570000000000
000000000000670000000000
000000000000000000000000

tilesheet outdoors
neighborw map1666658649344
neighbore map1666658660264
neighbors map1666658919835
