2c0000000000000000000000
2c0000000000000000000000
2c0000000074754600000000
2c0000000000005700000000
2c0000000000005700000000
2c0000000000006700000000
2c0000000000000000000000
2c0000000000000000000000

tilesheet outdoors
neighborn map1666658408918
neighbors map1666658419590
neighbore map1666658735497
