000000000000002527000000
000000000000002527000000
000000000000002527000000
000000001516162928161616
000000152926262626262626
000015292626262626262626
000035363636363636363636
1b1b1b1b1b1b1b1b1b1b1b1b

tilesheet outdoors
neighbore map1666659020563
neighborn map1666659015043
neighborw map1666659025829
