3b3b3b3b3b3b3b3b3b3b3b3b
000000000000000000000000
000000004475760000000000
000000005700000000000000
000000005475460000000000
000000005700570000000000
000000006475660000000000
000000000000000000000000

tilesheet outdoors
neighborw map1666658660264
neighbore map1666658672296
neighbors map1666658924194
