1d3b3b3b3b3c0000003a3b3b
2c0000000000000000000000
2c0000000000000000000000
2c0000470000004700000000
2c0000570000005700000000
2c0000670077006700000000
2c0000000000000000000000
2c0000000000000000000000

tilesheet outdoors
neighborn test_south
neighbors map1666658357668
neighbore map1666658618544
