2c0000000000000000000000
2c0000000000000000000000
2c0000000044757600000000
2c0000000057000000000000
2c0000000064754600000000
2c0000000000005700000000
2c0000000074756600000000
2c0000000000000000000000

tilesheet outdoors
neighborn map1666658395253
neighbors map1666658408918
neighbore map1666658725345
