3b3b3b3b3b3b3b3b3b3b3b3b
000000000000000000000000
000000004475760000000000
000000005700000000000000
000000006475460000000000
000000000000570000000000
000000007475660000000000
000000000000000000000000

tilesheet outdoors
neighborw map1666658655071
neighbore map1666658667512
neighbors map1666658922475
