00000000000000000000002a
00000000000000000000002a
00000000000000151616172a
00000000000000252626272a
16161616161616292626272a
36363636363636192626272a
00000000000000353636372a
00000000000000000000002a

tilesheet outdoors
neighborn map1666658960786
neighborw map1666658968980
neighbors map1666658988259
