1d3b3b3b3b3b3b3b3b3b3b1e
2c000000151700000000002a
2c000200252700010002003a
2c0000002527000000010000
2c0000002527000000000000
2c0000002527000000010000
2c0001003537000000000200
2d1b1b1b1b1b1b1b1b1b1b1b

tilesheet outdoors
neighbore begin
sprite 7 3 alphabet 0
sprite 8 2 alphabet 1
sprite 9 3 alphabet 2
sprite 8 4 alphabet 3
