000100000002000200000000
000000000000000000000100
000000000000000002000000
000000020000000000000000
000000000000000000000000
000200000000000100000000
000000000200000000000100
000000000100000000000000

tilesheet outdoors
neighborn map1666658725345
neighborw map1666658408918
neighbors map1666658735497
neighbore map1666658802785
