000000000000000100000000
000000000000000000000100
000001010100000001000000
010000020000000000000000
020000000000000000020000
000000000000000100000000
000200020000020000000000
000000000200000100020000

tilesheet outdoors
neighborn map1666658719968
neighborw map1666658402774
neighbors map1666658730336
neighbore map1666658804425
