2c0000000000000000005300
2c0000000000010000005300
2c0200020201000000005300
2c0001000000000000016071
2c0000010000000200000000
2c0000000002000201000000
2c0000000000000000000000
2c0000000000000000000000

tilesheet outdoors
neighborn map1666658328558
neighbors map1666658372757
neighbore map1666658708224
