f0f1f2f0f1f2f0f1f2f0f1f2
e2e0e1e2e0e1e2e0e1e2e0e1
f2f0f1f2f0f1f2f0f1f2f0f1
e0e1e2e0e1e2e0e1e2e0e1e2
f0f1f2f0f1f2f0f1f2f0f1f2
000000000000000000000000
717171717171717171717171
000000000000000000000000

tilesheet outdoors
neighbore map1666658975578
neighborn map1666658951370
neighborw map1666658804425
neighbors map1666658979413
