020000000000000000000000
000084858687880000000000
000094959600000100000000
0201a4a5a600000000000000
000001000000000000000000
000000000000000000000002
000000000000000000000000
1b1b1b1b1b1b1b1b1b1b1b1b

tilesheet outdoors
neighborn map1666658739913
neighborw map1666658429189
neighbore map1666658771576
