000000000025270000000000
000000000025270000000000
000000001529281700000000
000000002526262700000000
000000002526262700000000
000000003519183700000000
000000000025270000000000
000000000025270000000000

tilesheet outdoors
neighbore map1666658992066
neighborn map1666658986699
neighborw map1666659000682
neighbors map1666659015043
