2c0000000000000000000000
2c0000004475460000000000
2c0000005700570000000000
2c0000005475560000000000
2c0000005700570000000000
2c0000006475660000000000
2c0000000000000000000000
2d1c00000000000000000000

tilesheet outdoors
neighborn map1666658415501
neighbors map1666658429189
neighbore map1666658739913
