000000000000530000f0f1f2
000202000100530000e3e0e1
000000020000530000f3f0f1
000000000002530002e0e1e2
000000000000530001f0f1f2
000000000000530000000000
000000000000607171717171
000000000100000100020000

tilesheet outdoors
neighbors map1666658802785
neighborw map1666658725345
neighborn map1666658806001
neighbore map1666658977371
