000025270000000000000000
000025270000000000000000
000025281616170000000000
000035363619270000000000
000000000025270000000000
000000000025270000000000
000000000025270000000000
000000000025270000000000

tilesheet outdoors
neighborw map1666658985155
neighborn map1666658968980
neighbore map1666658988259
neighbors map1666658994323
