2c0000000000000000000000
2c0000000000007476000000
2c0000470000000000770000
2c0000570000000077000000
2c0000570000004700000000
2c0000670077006475760000
2c0000000000000000000000
2c0000000000000000000000

tilesheet outdoors
neighborn map1666658328558
neighbors map1666658372757
neighbore map1666658708224
