000001000000000000000000
000000000000000201020000
000000000000000000000000
000000000000000000000000
000200000001010200000200
000000000000020000000001
000000000000000000000100
000000000000020002000000

tilesheet outdoors
neighborn map1666658714873
neighborw map1666658395253
neighbors map1666658725345
neighbore map1666658806001
