000000000025270000000000
000000000025270000000000
000000000025270000000000
000000000025281617000000
000000000035361927000000
000000000000002527000000
000000000000002527000000
000000000000002527000000

tilesheet outdoors
neighborw map1666659013507
neighborn map1666658994323
neighbore map1666659016706
neighbors map1666659023843
