000000000000000000000000
000000000000000000000000
000015161616170000000000
000025261836370000000000
000025262700000000000000
000035363700000000000000
000000000000000000000000
000000000000000000000000

tilesheet outdoors
neighbore map1666658942233
neighborn map1666658925938
neighborw map1666658945851
neighbors map1666658956721
