3b3b3b3b3b3b3b3b3b3b3b1e
00000000000000000000002a
00000000447546000000002a
00000000570057000000002a
00000000647556000000002a
00000000000057000000002a
00000000000067000000002a
00000000000000000000002a

tilesheet outdoors
neighborw map1666658675841
neighbors map1666658929090
