020000000000020000010000
000000000000020000000000
000000000000000000000000
000002000000000000010200
000001000000000000000000
000000000000000000000000
000000000001010000000000
000000000000000000000000

tilesheet outdoors
neighborn map1666658618544
neighborw map1666658357668
neighbors map1666658714873
neighbore map1666658809105
