1d3b3b3b3b3c0000003a3b3b
2c0000000000000000000000
2c0000000200004300020000
2c0000020001005300000200
2c0000000000005300000001
2c0000000000006071714201
2c0002000000000000005300
2c0000000000000000005300

tilesheet outdoors
neighborn test_south
neighbors map1666658357668
neighbore map1666658618544
