2c0000000000000000000000
2c0000000000747546000000
2c0000000000000057000000
2c0000000000007456000000
2c0047004700000057000000
2c0064755600747566000000
2c0000005700000000000000
2c0075756600000000000000

tilesheet outdoors
neighborn map1666658357668
neighbors map1666658395253
neighbore map1666658714873
