00000000000000000000002a
00000000000000000000002a
00001516161617000000002a
16162926262627000000002a
26262626262627000000002a
26262626262627000000002a
36363636363637000000002a
1b1b1b1b1b1b1b1b1b1b1b2e

tilesheet outdoors
neighborn map1666659016706
neighborw map1666659023843
