000000000000000000000000
000000000000000000000000
00001a1c0000000000000000
00002a2c001a1b1c00000000
00002a2d1b2e1d3c00000000
00003a3b3b3b3c0000000000
000000000000000000000000
000000000000000000000000

tilesheet outdoors
neighborw map1666658922475
neighborn map1666658667512
neighbore map1666658925938
neighbors map1666658945851
