3b3b3b3b3b3b3b3b3b3b3b3b
000000000000000000000000
000000000074754602000000
0077007700000057011a1c00
0000770000447566012a2c00
0077007700570000003a3c00
000000000064757600000000
000000020000000000020001

tilesheet outdoors
neighborw map1666658328558
neighborn test_se
neighbore map1666658649344
neighbors map1666658708224
