000000000002020002020000
000100000001020200000000
010200000100000100000000
000002020000000200000001
000000000000000000000000
000001010001000201000000
010000000000000001000000
1b1b1b1b1b1b1b1b1b1b1b1b

tilesheet outdoors
neighborw map1666658745097
neighborn map1666658798617
neighbore map1666659031139
