000000020000000000000000
000000000000000001000000
000002000000000000010000
000001000000000001000000
000000000000000000000000
000002000001000001000100
000000000000000000000000
000000020000000000000000

tilesheet outdoors
neighborn map1666658730336
neighborw map1666658415501
neighbors map1666658739913
neighbore map1666658800855
