1d3c00000000000000000000
2c0000004475460000000000
2c0000005700570000000000
2c0000006475560000000000
2c0000000000570000000000
2c0000000000670000000000
2c0000000000000000000000
2d1b1b1b1b1b1b1b1b1b1b1b

tilesheet outdoors
neighborn map1666658419590
neighbore map1666658745097
