1d3b3b3b3b3c00003a3b3b1e
2c000000000000000000002a
2c000000000000000000003a
3c0000001a1b1b1c00000000
000000003a3b3b3c00000000
1c000000000000000000001a
2c000000000000000000002a
2d1b1b1b1c001a1b1b1b1b2e

tilesheet outdoors
neighborw begin
neighbors test_se
neighborn map1666480384151
