3d3d3d3d3d3d3d3d3d003d3d
3d000000000000000000003d
3d000000000000000000003d
3d0000000000000000000000
3d000000000000000000003d
3d000000000000000000003d
3d010002000300040000003d
3d3d3d3d3d3d3d3d3d3d3d3d

tilesheet outdoors
neighborn begin
neighbore test_se
