3d3d3d3d3d2b3d3d3d3d3d3d
3d2b2b2b2b2b2b2b2b2b2b3d
2b2b2b2b2b2b2b2b2b2b2b3d
2b2b2b2b2b2b2b2b2b2b2b3d
2b2b2b2b2b2b2b2b2b2b2b3d
3d2b2b2b2b2b2b2b2b2b2b3d
3d012b022b032b042b2b2b3d
3d3d3d3d3d3d3d3d3d3d3d3d

tilesheet outdoors
neighborn test_east
neighborw test_south
