3d3d3d3d3d003d3d3d3d3d3d
3d000000000000000000003d
3d000000000000000000003d
00000000000000000000003d
3d000000000000000000003d
3d000000000000000000003d
3d010002000300040000003d
3d3d3d3d3d3d3d3d00003d3d

tilesheet outdoors
neighborn test_east
neighborw test_south
