3d3d3d3d3d3d00003d3d3d3d
3d000000000000000000003d
3d000000000000000000003d
3d0000000000000000000000
000000000000000000000000
3d000000000000000000003d
3d000000000000000000003d
3d3d3d3d3d003d3d3d3d3d3d

tilesheet outdoors
neighborw begin
neighbors test_se
