1d3b3b3b3b3c00003a3b3b1e
2c000000000000000000002a
2c000000000100000000003a
3c0002001a1b1b1c00010000
000000003a3b3b3c00000000
1c000200000000000100011a
2c000000000201000000002a
2d1b1b1b1c001a1b1b1b1b2e

tilesheet outdoors
neighborw begin
neighbors test_se
neighborn map1666480384151
sprite 3 2 cow 
