1d3b3b3b3b3c00003a3b3b1e
2c000000000000c0c0c0c02a
2c000000000000c0c0c0c03a
3c0000001a1b1b1cc0c0c0c0
000000003a3b3b3cc0c0c0c0
1c00000000000000c0c0c01a
2c000000000000000000002a
2d1b1b1b1c001a1b1b1b1b2e

tilesheet outdoors
neighborw begin
neighbors test_se
neighborn map1666480384151
