7b7b7b7b7b7b7b7b7b7b7b7b
7bc0c0c0c0c0c0c0c0c0c07b
7bc0c0c0c0c0c0c0c0c0c07b
7bc0c0c0c0c0c0c0c0c0c07b
7bc0c0c0c0c0c0c0c0c0c07b
7bc0c0c0c0c0c0c0c0c0c07b
7bc0c0c0c0c0c0c0c0c0c07b
7b7b7b7b7b7bc07b7b7b7b7b

tilesheet outdoors
door 6 7 begin 7 6
