3d3d3d3d3d3d3d3d3d4b3d3d
3d4b4b4b4b4b4b4b4b4b4b3d
3d4b4b4b4b4b4b4b4b4b4b4b
3d4b4b4b4b4b4b4b4b4b4b4b
3d4b4b4b4b4b4b4b4b4b4b4b
3d4b4b4b4b4b4b4b4b4b4b3d
3d014b024b034b044b4b4b3d
3d3d3d3d3d3d3d3d3d3d3d3d

tilesheet outdoors
neighborn begin
neighbore test_se
