7b7b7b7b7b7b7b7b7b7b7b7b
7b000000000000000000007b
7b000000000000000000007b
7b000000000000000000007b
7b000000000000000000007b
7b000000000000000000007b
7b000000000000000000007b
7b7b7b7b7b7b007b7b7b7b7b

tilesheet outdoors
door 6 7 begin 7 6
